##########
#E W#    #
# #   ## #    
# # #    #
#   ## ###
##       #
#  # ### #
# ##   # #
#    #   #
##########