##########
#E  #S   #
# #   ## #
# # #   N#
#  W## ###
##      S#
#  # ### #
# ##  W# #
#N   #   #
##########